             C        255    ,      128           ,   0

  NO./textures/cat.xpm









             EA./textures/east.xpm
F128,0,255





WE./textures/floar.xpm

SO./textures/teapot.xpm
1                                1

              1111111        
                                  1

 11             1111111111111111111111111
 11             1000000000110000000000001
         1      1011000001110000000000001
                1001000000000000000000001
        111111111011000001110000000000001
        100000000011000001110111111111111
        11110111111111011100000010001
        11110111111111011101010010001         
        11000000110101011100000010001       111
        10000000000000001100000010001       101
        10000000N00000001101010010001       111
     1  110000011101010111110111100111         
        11110111 1110101 101111010001
        11111111 1111111 111111111111         


1
              1111
             100001
             100001
              1111
1                            111111