NO./textures/cornfield.xpm
SO./textures/cornfield.xpm
WE./textures/cornfield.xpm
EA./textures/cornfield.xpm
C221, 251, 239
F117, 147, 99
1111111111111111111111111111111111111111111111111
1000000000000010000000100010000000100000000000001
1011111111111010111110101010111110101111111111101
1010000000000010100010101010100010100000000000101
1010111111111110101010101010101010111111111110101
1010000000000000101010001000101010000000000010101
1011111111111111101011111111101011111111111010101
1010000000000000001010000000101000000000000010101
1010111111111111111010111110101111111111111110101
1010000010000000000010100010100000000000100000101
1011111010111111111110101010111111111110101111101
1000001010100000000000101010000000000010101000001
1111101010101111111111101011111111111010101011111
1000001010101000000100001000010000001010101000001
1011111010101011110101111111010111101010101111101
1010000010101010000100001000010000101010100000101
1010111110101010111111101011111110101010111110101
1010100000101010100000001000000010101010000010101
1010101111101010101111111111111010101011111010101
1010100000001010101000001000001010101010000010101
1010111111111010101011101011101010101010111110101
1010000010000010001010001000100010100010100000101
1011111010111111111010111110111110111110101111101
1000001010000010000010100010100000100000101000001
1111101011111010111110100010101111101111101011111
1000001010000010000010100010100000100000101000001
1011111010111111111010110110111110111110101111101
1010000010000010001010010100100010100010100000101
1010111111111010101011010101101010101010111110101
1010100000001010101001010100001010101010000010101
1010101111101010101101010111111010101011111010101
1010100000101010100001010000100010101010000010101
1010111110101010111111011110101110101010111110101
1010000010101010000001010000100000101010100000101
1011111010101011111101010111111111101010101111101
1000001010101000000001010000000000001010101000001
1111101010101111111111011111111111111010101011111
1000001010100000000000000100000010000010101000001
1011111010111111111111010101111010111110101111101
1010000010000000010000010101000010000010100000101
1010111111111111010111110101011111111010111110101
1010000000010000010000010101000010000010000010101
1011111111010111111111010101111010111111111010101
1010000000010000010000010101000010000010000010101
1010111111111111010111110101011111111010111110101
1010000000010000010000010101000000000010000000101
1011111111010111111111010101111111111111111111101
100000000001000000000001N100000000000000000000001
1111111111111111111111111111111111111111111111111