 NO ./textures/cat.xpm
  SO  ./textures/teapot.xpm
   EA   ./textures/wall.xpm
    WE    ./textures/tile.xpm

F 250,0,0
C 0,250,0

1111111
1000001
1000001
1000001      111111111
1000001      100000001
10N0001      101110001
1000001      111110001
1000001          10001
10000011111111111100011111111111
10000000000000000000000000000001
10000011111111111111111111111111
1000001
1000001
1000001
1000001
1000001
1000001
1000001
1111111
