 NO ./textures/cat.xpm
  SO  ./textures/teapot.xpm
   EA   ./textures/wall.xpm
    WE    ./textures/tile.xpm

F 250,0,0
C 0,250,0

11111
10001
10001
10001
10001
10N01
10001
10001
100011111111111111111111111111
100000000000000000000000000001
100011111111111111111111111111
10001
10001
10001
10001
10001
10001
10001
11111
