NO./textures/cat.xpm
SO./textures/teapot.xpm
EA./textures/wall.xpm
WE./textures/tile.xpm

F 220,100,0
C 225,30,0

1111111111
1000000001
1000000001
1000000001
1000000001110111
1000N00000000001
1000000001111111
1000000001
1000000001
1111111111